autobus – автобус [avtobus]
pociąg – поїзд [poyizd]
tramwaj – трамвай [tramvay]
samochód – машина [mashyna]
taksówka – таксі [taksi]
metro – метро [metro]
samolot – літак [litak]
lotnisko – аеропорт [aeroport]
bilet – квиток [kvytok]
dworzec autobusowy- автовокзал [avtovokzal]
dworzec kolejowy – залізнична станція [zaliznychna stantsiya]
informacja – інформація [informatsiya]
odjazd – виїзд [vyyizd]
przyjazd – прибуття [prybuttya]
opóźnienie – затримка [zatrymka]
przystanek autobusowy – автобусна зупинка [avtobusna zupynka]
peron – платформа [platforma]
poczekalnia – зал очікування [zal ochikuvannya]
rozkład jazdy – розклад [rozklad]
paszport – паспорт [pasport]
dokumenty – документи [dokumenty]
wiza – віза [viza]
kantor wymiany walut – обмін валюти [obmin valyuty]
ambasada – посольство [posolʹstvo]
bank – банк [bank]
pieniądze – гроші [hroszi]
bilet – квиток [kwytok]
wejście – вхід [wchid]
wyjście – Вихід [wychid]
muzeum – музей [muzey]
zamknięte – зачинено [zaczyneno]
toaleta – туалет [tualet]
apteka – аптека [apteka]
szpital – лікарня [likarnya]
